
                   1
             x     1                                                            1
        11                                                  1
        11             1
               1                        1
            111112311 1           111112311 1           111112311 1           111112311 1
1 1111111111111111111111111111111111111111111111111111111111111111111111111111111111111111       11111
1                                                                                            1       1
 1                                                                                         1         1
  1                                                                                      1           1
   1                                                                                   1             1
    1                                                                                1               1
     1                                                                              1               1
      1111111111111111111111111111111111111111111111111111111111111111111111111111111111111111111111